5	h o
12	h o
yui	h o
woods	w u dx z
अच	a c
अनारकली	a n aa r a k l ii
अनिवार	a n i w aa r
आयुर	aa y u r
आवेदन	aa w ee d a n
इसे	i s ee
उसका	u s a k aa
उसने	u s a n ee
ऐसा	ei s aa
ऐसे	ei s ee
और	ou r
क	k a
कभी	k a bh ii
कर	k a r
करण	k a r a nx
कराने	k a r aa n ee
कहा	k a h aa
कहां	k a h aa q
का	k aa
कालेधन	k aa l ee dh a n
कि	k i
किए	k i ee
किसी	k i s ii
की	k ii
के	k ee
कैश	k ei sh
को	k o
कोई	k o ii
कोशिश	k o sh i sh
खेल	kh ee l
गाने	g aa n ee
गुरु	g u r u
चालीस	c aa l ii s
चाहेगी	c aa h ee g ii
छह	ch a h
छा	ch aa
जनवरी	j a n a w r ii
जमा	j a m aa
जा	j aa
जाता	j aa t aa
जाती	j aa t ii
ट	tx a
टैक	tx ei k
ण	nx a
त	t a
तक	t a k
तथा	t a th aa
ति	t i
था	th aa
थापक	th aa p a k
दलों	d a l o q
देता	d ee t aa
देने	d ee n ee
दो	d o
ध	dh a
नहीं	n a h ii q
ने	n ee
नोटों	n o tx o q
प	p a
पतंजलि	p a t a q j a l i
पर	p a r
परीक	p a r ii k
पहले	p a h l ee
पाए	p aa ee
पास	p aa s
पांच	p aa q c
पिछले	p i ch l ee
पुराने	p u r aa n ee
पूछा	p uu ch aa
फायर	ph aa y a r
बाद	b aa d
बाबा	b aa b aa
बिचौलियों	b i c ou l i y o q
बीजेपी	b ii j ee p ii
बैंक	b ei q k
भद	bh a d
भाजपा	bh aa j p aa
महीने	m a h ii n ee
मालिकों	m aa l i k o q
में	m ee q
य	y a
यह	y a h
योग	y o g
रजनों	r a j n o q
रणाली	r a nx aa l ii
रसिद	r a s i d
रह	r a h
रहा	r a h aa
रही	r a h ii
राउंड	r aa u q dx
राजनीतिक	r aa j n ii t i k
राष	r aa sx
रांजेक	r aa q j ee k
रिकेट	r i k ee tx
रियान	r i y aa n
रीय	r ii y a
रुटिपूर	r u tx i p uu r
रुपये	r u p y ee
रूप	r uu p
रैपिड	r ei p i dx
लागू	l aa g uu
लिए	l i ee
लेकिन	l ee k i n
लोग	l o g
वयन	w a y a n
वयं	w a y a q
वर	w a r
वे	w ee
वेद	w ee d
शन	sh a n
षा	sx aa
षों	sx o q
स	s a
सकते	s a k t ee
सत	s a t
सभी	s a bh ii
समाप	s a m aa p
सालाना	s aa l aa n aa
से	s ee
सेवक	s ee w a k
सौ	s ou
संस	s a q s
हजार	h a j aa r
हम	h a m
हां	h aa q
हिंदी	h i q d ii
ही	h ii
है	h ei
हैं	h ei q
हो	h o
